002 002 002 002 002 002 002 002 002 002 002 002 002 002 000 000 000 002 000 000 000 000 000 000 000 000 002 000 000 002 000 000 000 000 000 000 000 000
002 002 002 002 002 002 002 002 002 002 002 002 002 002 000 000 002 000 000 000 000 000 000 002 000 000 000 000 000 000 000 000 000 000 000 000 000 000
002 002 002 002 002 002 002 002 002 002 002 002 002 002 000 000 000 000 002 000 000 000 000 000 000 000 000 000 000 000 000 002 000 000 000 000 000 000
002 002 002 002 002 002 002 002 002 002 002 002 002 002 000 000 000 000 000 000 000 000 000 002 000 000 000 000 002 000 000 000 000 000 000 000 000 000
002 002 002 002 002 002 002 002 002 002 002 002 002 002 000 000 002 000 000 000 000 000 000 000 000 000 000 000 000 000 000 000 002 000 000 000 000 000
002 002 002 002 002 002 002 002 002 002 002 002 002 002 000 000 000 000 002 000 000 000 000 000 000 000 002 000 000 000 000 000 000 000 000 000 000 000
002 002 002 002 002 002 002 002 002 002 002 002 002 002 000 000 000 000 000 000 000 000 000 002 000 000 000 000 000 000 002 000 000 000 000 000 000 000
002 002 002 002 002 002 002 002 002 002 002 002 002 002 000 000 002 000 000 000 000 002 000 000 000 000 002 000 000 000 000 000 000 000 000 000 000 000
002 002 002 002 002 002 002 002 002 002 002 002 002 002 000 000 000 000 000 000 000 000 000 000 000 000 000 000 000 000 000 000 002 000 000 000 000 000
002 002 002 002 002 002 002 002 002 002 002 002 002 002 002 002 002 002 002 002 002 002 000 000 000 000 000 000 000 000 002 000 000 000 000 000 000 000
002 002 002 002 002 002 002 002 001 001 001 001 001 001 001 001 001 001 001 001 001 002 078 079 084 085 090 091 096 097 000 000 000 000 000 000 000 000
002 002 002 002 002 002 002 002 001 001 001 001 001 001 001 001 001 001 001 001 001 002 080 081 086 087 092 093 098 099 002 000 000 000 000 000 000 000
002 002 002 002 002 002 002 002 002 102 103 104 105 106 002 050 051 052 053 001 001 002 082 083 088 089 094 095 100 101 000 000 000 000 000 000 000 000
002 002 002 002 002 002 002 002 002 107 108 109 110 111 000 054 055 056 057 001 001 001 001 001 001 001 001 001 001 001 002 000 000 000 000 000 000 000
002 002 002 002 002 002 002 002 002 112 113 114 115 116 000 058 059 060 061 001 001 001 001 001 001 001 001 001 001 001 002 000 000 000 000 000 000 000
000 000 000 000 000 000 000 000 000 117 118 119 120 121 000 062 063 064 065 001 001 002 002 002 002 002 002 002 002 002 002 000 000 000 000 000 000 000
000 000 000 000 000 000 000 000 000 000 000 000 000 000 000 066 067 068 069 001 001 002 030 031 032 033 002 000 000 000 000 000 000 000 000 000 000 000
000 000 000 000 000 000 002 000 000 000 000 000 000 000 002 001 001 001 001 001 001 002 034 035 036 037 002 000 000 000 000 000 000 000 000 000 000 000
000 000 000 000 000 000 000 000 000 000 002 000 000 000 002 001 001 001 001 001 001 002 038 039 040 041 002 000 000 002 000 000 000 000 000 000 000 000
000 000 000 000 000 000 000 000 000 000 000 000 000 000 002 002 002 002 002 001 001 002 042 043 044 045 002 000 000 000 000 000 000 000 000 000 000 000
000 000 000 000 002 000 000 002 002 002 002 002 002 002 002 002 002 002 002 001 001 002 046 047 048 049 002 000 000 000 002 000 000 000 000 000 000 000
000 000 000 000 000 000 000 002 001 001 001 001 001 001 001 001 001 001 001 001 001 001 001 001 001 001 002 000 002 000 000 000 000 000 000 000 000 000
000 000 002 000 000 000 000 002 001 001 001 001 001 001 001 001 001 001 001 001 001 001 001 001 001 001 002 000 000 002 000 000 000 000 000 000 000 000
000 000 000 000 002 000 000 002 001 001 002 002 002 002 002 002 002 002 002 002 002 002 002 002 002 002 002 000 000 000 000 000 000 000 000 000 000 000
000 000 000 000 000 000 000 002 001 001 002 000 000 000 000 000 000 000 000 000 000 000 000 000 000 000 000 000 000 000 000 002 000 000 000 000 000 000
000 000 000 002 000 002 000 002 001 001 002 000 000 002 000 000 000 002 000 000 002 000 000 002 000 000 000 000 000 000 000 000 000 000 000 000 000 000
000 002 000 000 000 000 000 002 001 001 002 000 000 000 000 002 000 000 000 000 000 000 000 000 000 000 000 000 000 002 000 000 000 000 000 000 000 000
000 000 000 000 002 000 000 002 001 001 002 000 000 000 000 000 000 000 000 000 000 002 000 000 002 000 002 000 000 000 000 000 002 000 000 000 000 000
000 000 000 000 011 010 010 010 070 071 010 010 010 017 000 000 000 000 000 000 000 000 000 000 000 000 000 000 000 000 000 000 000 000 000 000 000 000
000 000 000 011 019 018 018 018 072 073 018 018 018 022 017 000 000 000 000 000 000 000 000 000 000 000 002 000 000 002 000 000 000 000 000 000 000 000
000 000 011 019 018 018 018 018 074 075 018 018 018 018 022 017 000 000 002 000 000 000 000 000 000 000 000 000 000 000 000 000 000 000 000 000 000 000
000 000 012 018 018 018 018 018 076 077 018 018 018 018 018 016 000 000 002 000 000 000 000 000 000 000 000 000 000 000 000 000 002 000 000 000 000 000
000 000 012 018 018 018 018 018 018 018 018 018 018 018 018 016 000 000 000 000 000 000 000 000 000 000 000 000 000 000 000 000 000 000 000 000 000 000
000 000 013 020 018 018 018 018 018 018 018 018 018 018 021 015 000 000 000 000 000 000 000 000 000 000 000 000 000 002 000 002 000 000 000 000 000 000
000 000 000 013 020 018 018 018 018 018 018 018 018 021 015 000 000 000 000 000 000 000 000 000 000 000 000 000 000 000 000 000 000 000 000 000 000 000
000 000 000 000 013 014 014 014 014 014 014 014 014 015 000 000 000 000 000 000 000 000 000 000 000 000 000 000 000 000 002 000 000 000 000 000 000 000
000 000 000 000 000 000 000 000 000 000 000 000 000 000 000 000 000 000 000 000 000 000 000 002 002 000 000 000 000 000 000 000 000 000 000 000 000 000
000 000 000 002 000 000 000 000 000 000 000 000 000 002 000 000 000 000 000 000 000 000 000 000 000 000 000 000 000 000 000 000 000 000 000 000 000 000
000 000 000 000 000 000 002 000 000 000 000 000 000 000 000 000 000 000 000 000 000 000 000 000 000 000 000 002 000 000 000 000 000 000 000 000 000 000
000 000 002 000 000 000 000 000 000 000 000 000 002 000 000 000 000 002 000 000 000 000 000 000 000 000 000 000 000 000 000 000 000 000 000 000 000 000
000 000 000 000 000 002 000 000 000 000 000 000 000 000 000 000 000 000 000 000 000 000 000 000 000 000 002 000 000 000 000 000 000 000 000 000 000 000
000 000 000 000 000 000 000 000 000 000 000 000 000 000 000 000 000 000 000 000 000 000 000 000 000 000 000 000 000 000 000 000 000 000 000 000 000 000
000 000 000 000 000 000 000 000 000 000 000 000 000 000 000 000 000 000 000 000 000 000 000 000 000 000 000 000 000 000 000 000 000 000 000 000 000 000