02 02 02 02 02 02 02 02 02 02 02 02 02 02 00 00 00 02 00 00 00 00 00 00 00 00 02 00 00 02 00 00 00 00
02 02 02 02 02 02 02 02 02 02 02 02 02 02 00 00 02 00 00 00 00 00 00 02 00 00 00 00 00 00 00 00 00 00
02 02 02 02 02 02 02 02 02 02 02 02 02 02 00 00 00 00 02 00 00 00 00 00 00 00 00 00 00 00 00 02 00 00
02 02 02 02 02 02 02 02 02 02 02 02 02 02 00 00 00 00 00 00 00 00 00 02 00 00 00 00 02 00 00 00 00 00
02 02 02 02 02 02 02 02 02 02 02 02 02 02 00 00 02 00 00 00 00 00 00 00 00 00 00 00 00 00 00 00 02 00
02 02 02 02 02 02 02 02 02 02 02 02 02 02 00 00 00 00 02 00 00 00 00 00 00 00 02 00 00 00 00 00 00 00
02 02 02 02 02 02 02 02 02 02 02 02 02 02 00 00 00 00 00 00 00 00 00 02 00 00 00 00 00 00 02 00 00 00
02 02 02 02 02 02 02 02 02 02 02 02 02 02 00 00 02 00 00 00 00 02 00 00 00 00 02 00 00 00 00 00 00 00
02 02 02 02 02 02 02 02 02 02 02 02 02 02 00 00 00 00 00 00 00 00 00 00 00 00 00 00 00 00 00 00 02 00
02 02 02 02 02 02 02 02 02 02 02 02 02 02 02 02 02 02 02 02 02 02 02 02 02 02 02 00 00 00 02 00 00 00
02 02 02 02 02 02 02 02 01 01 01 01 01 01 01 01 01 01 01 01 01 01 01 01 01 01 02 00 00 00 00 00 00 00
02 02 02 02 02 02 02 02 01 01 01 01 01 01 01 01 01 01 01 01 01 01 01 01 01 01 02 00 00 00 02 00 00 00
02 02 02 02 02 02 02 02 02 04 04 04 04 04 02 50 51 52 53 01 01 02 02 02 02 02 02 00 00 00 00 00 00 00
02 02 02 02 02 02 02 02 02 04 04 04 04 04 00 54 55 56 57 01 01 02 00 00 00 00 00 00 02 00 00 02 00 00
02 02 02 02 02 02 02 02 02 04 04 04 04 04 00 58 59 60 61 01 01 02 00 00 00 00 00 00 00 00 00 00 00 00
00 00 00 00 00 00 00 00 00 04 04 04 04 04 00 62 63 64 65 01 01 02 00 00 02 00 00 00 00 00 00 00 00 00
00 00 00 00 00 00 00 00 00 00 00 00 00 00 00 66 67 68 69 01 01 02 00 00 00 02 00 00 02 00 00 02 00 00
00 00 00 00 00 00 02 00 00 00 00 00 00 00 02 01 01 01 01 01 01 02 00 00 00 00 00 00 00 00 00 00 00 00
00 00 00 00 00 00 00 00 00 00 02 00 00 00 02 01 01 01 01 01 01 02 00 00 00 00 02 00 00 00 02 00 00 00
00 00 00 00 00 00 00 00 00 00 00 00 00 00 02 02 02 02 02 01 01 02 00 00 00 00 00 00 00 00 00 00 00 00
00 00 00 00 02 00 00 02 02 02 02 02 02 02 02 02 02 02 02 01 01 02 02 02 02 02 00 00 00 00 02 00 00 00
00 00 00 00 00 00 00 02 01 01 01 01 01 01 01 01 01 01 01 01 01 01 01 01 01 02 00 00 00 00 00 00 00 00
00 00 02 00 00 00 00 02 01 01 01 01 01 01 01 01 01 01 01 01 01 01 01 01 01 02 00 00 00 02 00 00 00 00
00 00 00 00 02 00 00 02 01 01 02 02 02 02 02 02 02 02 02 02 02 02 02 01 01 02 00 00 00 00 00 00 00 00
00 00 00 00 00 00 00 02 01 01 02 00 00 00 00 00 00 00 00 00 00 00 02 01 01 02 00 00 00 00 00 02 00 00
00 00 00 02 00 02 00 02 01 01 02 00 00 02 00 00 00 02 00 30 31 32 33 01 01 04 04 00 00 00 00 00 00 00
00 02 00 00 00 00 00 02 01 01 02 00 00 00 00 02 00 00 00 34 35 36 37 01 01 04 04 00 00 02 00 00 00 00
00 00 00 00 02 00 00 02 01 01 02 00 00 00 00 00 00 00 00 38 39 40 41 01 01 04 04 00 00 00 00 00 02 00
00 00 00 00 11 10 10 10 70 71 10 10 10 17 00 00 00 00 00 42 43 44 45 01 01 04 04 00 00 00 00 00 00 00
00 00 00 11 19 18 18 18 72 73 18 18 18 22 17 00 00 00 00 46 47 48 49 01 01 04 04 00 00 02 00 00 00 00
00 00 11 19 18 18 18 18 74 75 18 18 18 18 22 17 00 00 02 01 01 01 01 01 01 04 04 00 00 00 00 00 00 00
00 00 12 18 18 18 18 18 76 77 18 18 18 18 18 16 00 00 02 01 01 01 01 01 01 04 04 00 00 00 00 00 02 00
00 00 12 18 18 18 18 18 18 18 18 18 18 18 18 16 00 00 00 04 04 04 04 01 01 04 04 00 00 00 00 00 00 00
00 00 13 20 18 18 18 18 18 18 18 18 18 18 21 15 00 00 00 04 04 04 04 01 01 04 04 00 00 02 00 02 00 00
00 00 00 13 20 18 18 18 18 18 18 18 18 21 15 00 00 00 00 04 04 04 04 01 01 04 04 00 00 00 00 00 00 00
00 00 00 00 13 14 14 14 14 14 14 14 14 15 00 00 00 00 00 04 04 04 04 01 01 04 04 00 00 00 02 00 00 00
00 00 00 00 00 00 00 00 00 00 00 00 00 00 00 00 00 00 00 00 00 00 00 02 02 00 00 00 00 00 00 00 00 00
00 00 00 02 00 00 00 00 00 00 00 00 00 02 00 00 00 00 00 00 00 00 00 00 00 00 00 00 00 00 00 00 00 00
00 00 00 00 00 00 02 00 00 00 00 00 00 00 00 00 00 00 00 00 00 00 00 00 00 00 00 02 00 00 00 00 00 00
00 00 02 00 00 00 00 00 00 00 00 00 02 00 00 00 00 02 00 00 00 00 00 00 00 00 00 00 00 00 00 00 00 00
00 00 00 00 00 02 00 00 00 00 00 00 00 00 00 00 00 00 00 00 00 00 00 00 00 00 02 00 00 00 00 00 00 00
00 00 00 00 00 00 00 00 00 00 00 00 00 00 00 00 00 00 00 00 00 00 00 00 00 00 00 00 00 00 00 00 00 00
00 00 00 00 00 00 00 00 00 00 00 00 00 00 00 00 00 00 00 00 00 00 00 00 00 00 00 00 00 00 00 00 00 00